###############################
#p           1        2 2 2   #
# # # # # # #2#2# # # #2#2#2# #
#  x        2  2  1   2 2 2 2 #
# # # # # #2# # #2#2# # # # #2#
#f  1111   x 22  2  2   1     #
# # # # # # # # # #2# #2# # # #
#2  21111  2  2 1111 2        #
# # # # #2# # # #2#2# # # # # #
#2    22  2       2     1111  #
# #2# # # # # # #2# # # # # # #
#    1111   2   2  2    1111  #
###############################