###############################
#p     ** *  1 * 2 *  * * *   #
# # # #*# # #*#*# # # #*#*#*# #
#  x*     ***  *  1   * 2 * * #
# # # # # #*# # #*#*# # # # #*#
#f         x **  *  *   1     #
# # # # # # # # # #*# #*# # # #
#*  *1111  *  *      *        #
# # # # #*# # # #*#*# # # # # #
#*    **  *       *     1111  #
# #*# # # # # # #*# # # # # # #
#    1111   *   *  *    1111  #
###############################