###############################
#p     ** *  1 * 2 *  * * *   #
# # # #*# # #*#*# # # #*#*#*# #
#  x*     ***  *  1   * 2 * * #
# # # # # #*# # #*#*# # # # #*#
#f         x **  *  *   1     #
# # # # # # # # # #*# #*# # # #
#*  *1111  *  * 222  *        #
# # # # #*# # # #*#*# # # # # #
#*    **  * 2222  *     1111  #
# #*# # # # # # #*# # # # # # #
#    1111   *22 *  *    1111  #
###############################