###############################
#p     ** * 1  * 2 *  * * *   #
# # # #*# # #*#*# # # #*#*#*# #
#  x*     ***  *      * 2 * * #
# # # # # #*# # #*#*# # # # #*#
#f         x **  *  *         #
# # # # # # # # # #*# #*# # # #
#*  *      *  *      *        #
# # # # #*# # # #*#*# # # # # #
#*    **  *       *           #
# #*# # # # # # #*# # # # # # #
#           *   *  *          #
###############################