###############################
#p        * 1      *  * * *   #
# # # #*# # #*#*# # # #*#*#*# #
#  x      ***         *   * * #
# # # # # #*# # # # # # # # #*#
#f         x                  #
# # # # # # # # # # # # # # # #
#                    2        #
# # # # # # # # # # # # # # # #
#                             #
# # # # # # # # # # # # # # # #
#                             #
###############################