###############################
#p     ** *  1 * 2 *  * * *   #
# # # #*# # #*#*# # # #*#*#*# #
#  x*     ***  *  1   * 2 * * #
# # # # # #*# # #*#*# # # # #*#
#f         x 222222222  1     #
# # # # # # # # # #*# #*# # # #
#*  *2222  *  * 1111 *        #
# # # # #*# # # #*#*# # # # # #
#*    2222222     *     1111  #
# #*# # # # # # #*# # # # # # #
#    1111   *   *  *    1111  #
###############################