###############################
#p     ** *  1 * 2 *  * * *   #
# # # #*# # #*#*# # # #*#*#*# #
#  x*     ***  *  1   * 2 * * #
# # # # # #*# # #*#*# # # # #*#
#f  1111   x **  *  *   1     #
# # # # # # # # # #*# #*# # # #
#*  *1111  *  * 1111 *        #
# # # # #*# # # #*#*# # # # # #
#*    **  *       *     1111  #
# #*# # # # # # #*# # # # # # #
#    1111   *   *  *    1111  #
###############################